@@@@@@@@@@@@@@@@@@@@@@@@@@@@@@@@@@@@@@@@@@@@@@@@@@@@@@@@@@@@@@@@@@@@@@@@@@@@@@@@@@@@@@@@@@@@@@@@@@@@
@##################################################################################################@
@#     $                                                                                          #@
@#   #####=                                  =#########=                                          #@
@#        =                                  =         =                                          #@
@#        =           ----------------    $  =         =                                          #@
@#        ###########=                =#######         =                                          #@
@#                   =             =###                =                                          #@
@#                   =             =                   =                  -------   $             #@
@#         $         =             ###=###################@@########=#####       #######=         #@
@#@@@########################=        =         $               $   =                   =         #@
@#                           =        =      ######           =##########=              =         #@
@#                           =        =                       =          =              =         #@
@#                           =        =                       =          =              =         #@
@#                           =    $   =        ---------      =          #######=########         #@
@#                   =########################=         ##=########=            =                 #@
@#                   =###############################=    =        =            =                 #@
@#                   =                               =#####        =            =                 #@
@#                   =                               =             =            =                 #@
@#                   =              $                =             =            = $               #@
@########@@@@@################=##########################=####@@##############################=####@
@#         $                  =                          =                                    =   #@
@#####=##################=######################=        =                                    =   #@
@#    =                  =                      ####=#####################=########################@
@#    =        =############=                       =                     =                       #@
@#    =        =            =     --------          =                     =                       #@
@#    =        =            ######        =##############=                =                       #@
@#    =        =                          =              =                =      $                #@
@##################################################################################################@
@@@@@@@@@@@@@@@@@@@@@@@@@@@@@@@@@@@@@@@@@@@@@@@@@@@@@@@@@@@@@@@@@@@@@@@@@@@@@@@@@@@@@@@@@@@@@@@@@@@@
