@@@@@@@@@@@@@@@@@@@@@@@@@@@@@@@@@@@@@@@@@@@@@@@@@@@@@@@@@@@@@@@@@@@@@@@@@@@@@@@@@@@@@@@@@@@@@@@@@@@@@@@@@@@@@@@@@@@@@@@@
@######################################################################################################################@
@#                                                                                                                    #@
@#  =############=              =###########=                =###############=                                        #@
@#  =            =              =           =                =               =                                        #@
@#  =   $        =              =           =                =               =                   $                    #@
@#  ####################=#######################=         =###          =###############=############                 #@
@#                      =                       =         =             =               =                             #@
@#                      =           $           = ----    =             =               =                             #@
@#                 =##############################    #########################################=                      #@
@#       $         =     ------------------                                                    =                      #@
@#######################=                  =#################=                                 =                      #@
@#                      =                  =                 =                                 =                      #@
@#                      =                  =             $   =                             $   =                      #@
@#      =########################################=#####################=###############################################@
@#      =                                        =                     =                  #############################@
@#      =       --------   $    ------------     =                     = ----------       #############################@
@#      ########        ####=###            #############################          ###=####                           #@
@#                          =                                                         =   #                           #@
@#                          =                                      $                  =   #                           #@
@#       =#################################=##########=############################=#######                           #@
@#       =                                 =          =                            =                                  #@
@#       =                                 =          =                            =               $                  #@
@#       =                              =##############################################################################@
@#       =                              =                                                                             #@
@#       =                        =#######=                                                                           #@
@#       =  $                     = ----- =                      ---------                                            #@
@#       #########=#################     ########=##############=         ##=##################=                      #@
@#                =                              =              =           =                  =                      #@
@#                =                              =              =           =    ----    $     =                      #@
@#                =                              ###########################=####    ######=####                      #@
@#                =                                                         =              =                          #@
@#                =                                                         =              =                          #@
@######################################################################################################################@
@@@@@@@@@@@@@@@@@@@@@@@@@@@@@@@@@@@@@@@@@@@@@@@@@@@@@@@@@@@@@@@@@@@@@@@@@@@@@@@@@@@@@@@@@@@@@@@@@@@@@@@@@@@@@@@@@@@@@@@@
