@@@@@@@@@@@@@@@@@@@@@@@@@@@@@@@@@@@@@@@@@@@@@@@@@@@@@@@@@@@@@@@@@@@@@@@@@@@@@@@@@@@@@@@@@@@@@@@@@@@@@@@@
@######################################################################################################@
@#                                                                                                    #@
@#                                                                                                    #@
@#       ######                                                                                       #@
@#                                                                                                    #@
@#                                                                                                    #@
@#                                                                                                    #@
@#                                                                                                    #@
@#                                                                                                    #@
@#                                                                                                    #@
@#                                                                                                    #@
@#                                                                                                    #@
@#                                                                                                    #@
@#                                                                                                    #@
@#            ####                                                                                    #@
@#                                                                                                    #@
@#                                                                                                    #@
@#                                                                                                    #@
@#                                                                                                    #@
@#                                                                                                    #@
@#                                                                                                    #@
@#                                                                                                    #@
@#                                                                                                    #@
@#                                                                                                    #@
@#                                                                                                    #@
@#               $                                                                                    #@
@######################################################################################################@
@@@@@@@@@@@@@@@@@@@@@@@@@@@@@@@@@@@@@@@@@@@@@@@@@@@@@@@@@@@@@@@@@@@@@@@@@@@@@@@@@@@@@@@@@@@@@@@@@@@@@@@@
